10,10,10,10,10,11,11,11,11,10,10,10,10,10,10,10,10,10,10,10,10,10,10,10,10,10,10,10,10,10,10,10,
10,9,9,1,2,10,11,11,11,1,1,1,2,1,9,1,1,1,9,1,10,11,9,9,1,8,8,8,1,1,8,10,
10,9,1,1,10,10,11,11,11,1,1,8,1,1,9,1,11,1,9,1,10,10,10,1,1,1,11,1,9,2,8,10,
10,1,9,1,2,10,11,11,11,1,1,8,8,1,10,1,1,1,1,1,10,1,10,10,2,2,1,1,11,1,1,10,
10,1,1,2,8,10,11,11,11,11,1,1,1,1,1,1,2,2,1,1,1,1,10,1,10,2,2,1,11,1,2,10,
10,1,1,10,10,10,11,11,11,11,11,1,1,1,9,1,2,1,1,1,11,11,1,10,1,1,9,1,8,1,1,10,
10,1,8,1,1,10,10,1,11,11,11,11,11,1,1,1,1,10,1,1,11,1,1,8,10,10,1,10,1,1,8,10,
10,10,1,1,10,1,10,10,11,11,11,11,11,1,1,1,8,1,1,1,1,11,11,11,10,10,10,10,9,1,8,10,
10,1,1,1,2,2,2,10,10,11,11,11,11,1,1,2,1,1,9,1,1,1,1,11,1,1,1,2,10,10,8,10,
10,11,2,1,1,2,2,1,10,1,1,11,11,11,1,2,2,2,1,1,1,1,1,1,1,9,1,1,1,10,10,10,
10,11,1,11,1,1,1,10,10,10,11,11,11,11,11,1,1,1,1,1,10,2,1,2,1,1,1,1,1,11,10,10,
10,1,1,11,1,1,9,1,8,10,10,11,11,11,11,1,8,1,1,1,1,1,1,1,8,1,1,2,1,1,1,10,
10,1,1,11,11,1,9,1,1,8,10,11,11,11,1,1,1,9,1,9,1,1,1,1,1,1,1,1,8,1,1,10,
10,1,8,10,11,1,1,1,10,10,10,11,11,1,1,1,1,1,1,1,1,1,1,1,1,1,10,1,8,8,8,10,
10,1,1,10,8,2,2,10,10,11,11,11,11,1,2,2,1,1,8,1,1,1,1,1,1,1,10,10,1,1,1,10,
10,2,2,1,1,1,2,10,11,11,11,11,1,1,1,2,1,1,1,8,1,1,1,1,1,1,1,1,1,8,1,10,
10,1,1,11,1,8,10,10,10,11,11,11,11,1,1,1,10,1,1,1,1,1,1,1,1,1,1,9,8,8,1,10,
10,1,1,11,10,10,11,11,11,11,11,1,1,8,8,10,1,11,11,11,11,1,1,1,1,10,1,1,8,1,1,10,
10,1,10,11,10,2,11,11,11,11,11,1,2,1,1,1,8,11,11,11,11,11,1,2,10,10,1,1,1,11,1,10,
10,10,10,10,1,1,1,11,11,11,11,2,1,1,8,11,11,11,11,11,11,1,1,1,1,1,1,1,1,1,1,10,
10,10,2,1,10,1,1,8,11,11,11,11,11,1,11,11,11,11,11,1,1,1,2,1,2,1,15,1,2,2,2,10,
10,1,1,1,1,2,1,8,1,11,11,11,11,11,11,11,11,11,11,1,1,2,1,1,1,1,9,1,1,2,1,10,
10,1,11,11,1,2,1,1,1,11,11,11,11,11,11,11,11,11,1,1,2,1,9,1,8,1,1,1,10,10,1,10,
10,1,11,1,1,1,8,8,1,1,1,1,1,11,11,11,11,11,11,11,1,1,1,2,1,1,10,1,1,1,1,10,
10,1,2,1,10,1,1,1,8,8,1,1,1,1,11,11,11,11,11,11,1,1,1,1,1,1,10,1,1,1,1,10,
10,1,11,1,1,1,2,1,1,1,1,2,1,1,11,11,11,11,11,11,11,11,11,1,1,1,1,1,1,2,1,10,
10,1,2,1,1,2,1,9,1,1,1,1,1,1,1,1,1,1,11,11,11,11,11,11,11,1,1,1,8,1,1,10,
10,1,1,1,8,1,15,1,8,1,1,11,1,2,1,1,1,1,11,11,1,1,11,11,11,11,1,1,8,8,1,10,
10,8,1,11,8,8,1,8,8,1,1,1,1,1,1,2,1,1,8,8,8,1,11,11,11,11,11,11,1,1,1,10,
10,1,2,11,1,1,1,1,1,1,1,9,1,10,1,1,1,1,1,1,1,1,1,1,11,11,11,11,1,2,10,10,
10,1,11,1,2,1,10,1,1,2,1,1,1,10,1,1,8,1,1,1,1,1,1,1,11,11,11,11,1,2,2,10,
10,1,11,11,1,1,10,10,1,1,1,1,8,1,1,1,1,1,10,1,8,1,8,1,1,11,11,11,1,1,1,10,
10,2,11,11,11,2,1,1,10,10,1,1,8,8,2,1,1,2,1,1,1,1,1,1,1,11,11,11,11,8,10,10,
10,1,11,1,1,1,1,1,1,1,1,1,1,8,8,1,1,1,1,1,1,1,1,1,1,11,11,11,11,1,1,10,
10,2,11,11,1,1,9,1,1,8,1,8,10,1,1,1,1,1,1,1,1,1,11,11,11,11,11,1,1,1,1,10,
10,1,1,1,8,1,1,8,1,1,1,1,1,1,1,1,1,1,11,11,11,11,11,11,11,11,1,1,1,8,1,10,
10,6,6,6,6,6,6,6,6,6,6,6,6,6,6,7,1,11,11,11,11,11,11,11,11,2,1,9,1,1,2,10,
13,13,13,13,13,13,13,13,13,13,13,13,13,13,13,13,1,11,11,11,13,13,13,13,13,13,13,13,13,13,13,13,
12,12,12,12,12,12,12,12,12,12,12,12,12,12,12,12,1,1,1,1,12,12,12,12,12,12,12,12,12,12,12,12,
14,14,14,14,14,14,14,14,14,14,14,14,14,14,14,14,1,1,1,1,14,14,14,14,14,14,14,14,14,14,14,14,
10,10,10,1,1,1,1,1,1,1,1,1,1,1,1,1,11,11,11,11,1,2,1,1,1,2,1,1,1,2,1,10,
10,1,2,10,1,8,1,2,1,2,1,10,8,2,1,1,11,11,11,11,1,2,1,1,1,1,2,1,1,1,1,10,
10,1,8,8,10,1,1,1,8,1,1,1,1,1,1,1,1,11,11,11,1,2,1,8,8,1,1,10,10,1,1,10,
10,8,1,1,10,10,1,9,8,2,2,1,1,1,8,1,1,11,11,11,1,2,2,8,1,1,1,10,1,11,8,10,
10,8,2,1,10,1,10,1,1,1,2,8,8,1,8,1,1,11,11,11,1,2,2,1,1,1,8,11,11,11,11,11,
10,8,1,1,1,1,10,10,10,10,1,1,1,1,1,2,1,11,11,11,11,1,11,11,11,11,11,2,11,11,11,11,
10,1,1,2,1,2,1,1,8,1,10,1,2,1,1,1,1,11,11,11,11,11,11,11,11,11,11,11,11,11,11,11,
10,2,1,1,9,8,8,1,1,1,1,10,1,1,2,1,1,1,11,11,11,11,11,11,11,11,11,11,11,11,11,11,
10,1,10,1,2,1,1,1,8,1,2,10,1,2,2,1,1,1,11,11,11,11,1,2,1,1,11,11,1,1,1,10,
10,10,10,10,10,10,10,10,10,10,10,10,10,10,10,10,10,10,10,10,10,10,10,10,10,10,10,10,10,10,10,10
