2 2 2 1 2 2 2 6 6 2 2 2 2 2 4 2 2 2 2 2 4 2 2 2 2 6 2 2 2 2 2 2
2 2 1 1 2 2 2 2 5 2 2 2 6 2 2 2 2 7 2 2 1 1 2 2 2 5 2 2 2 2 6 2
2 6 1 1 1 2 2 6 6 6 2 2 5 2 2 1 1 1 1 1 1 1 1 1 1 2 2 2 2 2 5 2
6 5 2 1 1 1 6 5 5 5 2 2 6 2 1 1 1 1 1 1 1 1 1 1 1 2 2 2 2 2 2 6
5 2 2 1 1 1 5 2 2 2 2 2 5 1 1 1 1 1 1 1 1 1 1 1 2 6 2 2 6 2 2 5
4 2 2 6 1 1 1 2 2 2 2 1 1 1 1 1 1 1 1 1 1 1 1 1 2 5 2 2 5 6 2 2
2 2 2 5 1 1 1 1 1 1 1 1 1 1 15 1 1 1 1 13 1 1 1 1 1 2 2 2 2 5 6 2
2 2 6 2 2 6 1 1 1 1 1 1 1 1 1 1 1 1 1 6 1 1 1 1 1 1 1 1 2 2 5 2
2 2 5 6 2 5 1 1 1 1 1 1 1 1 1 1 1 1 4 5 1 1 1 1 1 1 1 2 6 2 2 2
6 2 2 5 2 2 1 1 1 6 2 2 2 1 1 1 1 4 4 4 1 1 1 1 1 1 1 1 5 2 2 2
5 2 2 2 6 2 2 2 2 5 2 2 2 2 1 1 1 2 2 2 1 1 1 1 1 1 1 1 1 2 6 2
2 2 2 2 5 2 2 2 2 1 4 2 4 4 2 1 2 2 2 2 2 1 1 1 1 1 1 1 1 1 5 2
2 2 2 6 3 3 3 3 3 3 3 3 3 3 3 3 3 3 2 2 1 1 1 1 1 1 2 1 1 1 4 2
6 2 2 5 3 2 2 2 2 2 1 1 1 1 2 6 2 3 2 1 1 1 1 1 1 1 1 1 1 1 1 2
5 2 4 1 3 2 2 2 1 1 1 1 1 1 1 5 2 3 2 1 1 1 1 1 1 1 1 1 1 2 2 2
3 3 3 3 3 6 2 1 1 1 1 1 1 1 1 1 1 3 1 1 1 1 1 1 1 1 1 1 2 6 2 2
2 2 2 2 2 5 2 1 1 1 1 1 1 1 1 1 1 8 1 1 1 1 1 2 2 1 1 4 2 5 2 2
6 2 2 2 2 2 1 1 1 1 1 1 1 1 1 1 1 3 2 1 1 1 2 2 3 3 8 3 3 3 3 3
5 2 2 2 1 1 1 1 1 1 1 1 1 1 1 1 1 3 2 2 1 1 2 2 3 1 1 6 6 6 6 6
2 2 2 1 1 1 1 1 1 1 1 1 1 1 1 1 2 3 2 2 2 2 2 2 3 1 1 5 5 5 5 5
4 1 1 1 1 1 1 1 1 1 1 1 1 1 2 2 2 3 3 3 3 3 3 3 3 1 1 6 6 6 6 6
2 2 1 1 1 1 1 1 1 1 1 1 1 1 1 2 2 2 2 2 1 1 1 1 1 1 1 5 5 5 5 5
2 2 6 1 1 1 1 1 1 1 1 1 1 2 2 2 6 2 2 6 2 1 1 1 1 1 1 6 6 6 6 6
6 2 5 1 1 1 1 1 1 1 1 1 1 1 1 1 5 2 2 5 2 2 1 1 1 1 1 5 5 5 5 5
5 2 2 1 1 1 1 1 1 1 1 1 1 1 1 1 1 1 1 1 1 1 1 1 1 1 1 1 1 2 2 2
2 2 2 1 1 1 1 1 1 1 1 1 1 1 1 1 1 1 1 1 1 1 1 1 1 1 1 1 1 1 6 2
2 2 2 1 1 1 1 1 1 1 1 1 1 1 1 1 1 1 1 1 1 1 1 1 1 1 1 1 1 2 5 2
2 2 2 2 1 1 1 1 1 1 1 1 1 1 1 1 1 1 1 1 1 1 1 1 1 1 1 1 1 2 2 6
6 6 6 6 6 6 6 6 1 1 1 1 1 1 1 1 1 1 1 1 1 1 1 1 1 1 1 2 6 2 6 2
5 5 5 5 5 5 5 5 1 1 1 1 1 1 1 1 4 1 1 1 1 1 1 1 1 1 1 2 5 6 5 2
6 6 6 6 6 6 6 6 2 1 1 1 1 1 1 1 1 1 1 1 1 1 1 1 1 1 6 2 2 5 2 2
5 5 5 5 5 5 5 5 2 4 1 1 1 1 1 1 1 1 1 1 1 1 1 1 1 1 5 2 2 2 2 2
6 6 6 6 6 6 6 6 6 6 2 2 2 1 1 1 1 1 1 1 1 1 1 1 2 6 2 2 6 2 2 6
5 5 5 5 5 5 5 5 5 5 2 2 2 2 4 1 1 1 1 1 1 1 1 2 2 5 2 2 5 2 2 5
